{
    "0": [
        "m0_r0",
        "m7_r0",
        "m7_r1",
        "m8_r0"
    ],
    "1": [
        "m0_r0",
        "m1_r0",
        "m1_r1",
        "m1_r2",
        "m1_r3",
        "m5_r0",
        "m5_r1",
        "m5_r2",
        "m5_r3",
        "m6_r0",
        "m6_r1",
        "m6_r2",
        "m6_r3",
        "m9_r0"
    ],
    "default": [
        "m0_r0",
        "m1_r0",
        "m1_r1",
        "m1_r2",
        "m1_r3",
        "m2_r0",
        "m2_r1",
        "m2_r2",
        "m2_r3",
        "m3_r0",
        "m3_r1",
        "m3_r2",
        "m3_r3",
        "m5_r0",
        "m5_r1",
        "m5_r2",
        "m5_r3",
        "m6_r0",
        "m6_r1",
        "m6_r2",
        "m6_r3",
        "m7_r0",
        "m7_r1",
        "m8_r0",
        "m9_r0"
    ]
}